Name	Code
Arabic	ar
Chinese	zh
Czech	cs
Danish	da
Dutch	nl
English	en
Esperanto	eo
Finnish	fi
French	fr
German	de
Hindi	hi
Hungarian	hu
Italian	it
Japanese	ja
Klingon	tlh
Korean	ko
Norwegian	no
Persian	fa
Polish	pl
Portuguese	pt
Russian	ru
Spanish	es
Swedish	sv
Thai	th
Turkish	tr